{
  "stage_id": 1,
  "grid_map": [
    ["F", "F", "F", "F", "F", "F", "F", "F", "F", "F", "W", "F", "F", "F", "F", "F", "F", "F", "F", "F", "F", "F", "W", "F", "F", "F", "F", "F"],
    ["F", "F", "F", "F", "F", "F", "F", "F", "F", "F", "W", "F", "F", "F", "F", "F", "F", "F", "F", "F", "F", "F", "W", "F", "F", "F", "F", "F"],
    ["F", "F", "F", "F", "F", "F", "F", "F", "F", "F", "W", "F", "F", "F", "F", "F", "F", "F", "F", "F", "F", "F", "W", "F", "F", "F", "F", "F"],
    ["F", "F", "F", "F", "F", "F", "F", "F", "F", "F", "W", "F", "F", "F", "F", "F", "F", "F", "F", "F", "F", "F", "W", "F", "F", "F", "F", "F"],
    ["F", "F", "F", "F", "F", "F", "F", "F", "F", "F", "W", "F", "F", "F", "F", "F", "F", "F", "F", "F", "F", "F", "W", "F", "F", "F", "F", "F"],
    ["F", "F", "F", "F", "F", "F", "F", "F", "F", "F", "W", "F", "F", "F", "F", "F", "F", "F", "F", "F", "F", "F", "W", "F", "F", "F", "F", "F"],
    ["F", "F", "F", "F", "F", "W", "F", "F", "F", "F", "W", "F", "F", "F", "F", "F", "F", "W", "F", "F", "F", "F", "W", "F", "F", "F", "F", "F"],
    ["F", "F", "F", "F", "F", "W", "F", "F", "F", "F", "W", "F", "F", "F", "F", "F", "F", "W", "F", "F", "F", "F", "W", "F", "F", "F", "F", "F"],
    ["F", "F", "F", "F", "F", "W", "F", "F", "F", "F", "W", "F", "F", "F", "F", "F", "F", "W", "F", "F", "F", "F", "W", "F", "F", "F", "F", "F"],
    ["F", "F", "F", "F", "F", "W", "F", "F", "F", "F", "W", "F", "F", "F", "F", "F", "F", "W", "F", "F", "F", "F", "W", "F", "F", "F", "F", "F"],
    ["F", "F", "F", "F", "F", "W", "F", "F", "F", "F", "W", "F", "F", "F", "F", "F", "F", "W", "F", "F", "F", "F", "W", "F", "F", "F", "F", "F"],
    ["F", "F", "F", "F", "F", "W", "F", "F", "F", "F", "F", "F", "F", "F", "F", "F", "F", "W", "F", "F", "F", "F", "W", "F", "F", "F", "F", "F"],
    ["F", "F", "F", "F", "F", "W", "F", "F", "F", "F", "F", "F", "F", "F", "F", "F", "F", "W", "F", "F", "F", "F", "F", "F", "F", "F", "F", "F"],
    ["F", "F", "F", "F", "F", "W", "F", "F", "F", "F", "F", "F", "F", "F", "F", "F", "F", "W", "F", "F", "F", "F", "F", "F", "F", "F", "F", "F"],
    ["F", "F", "F", "F", "F", "W", "F", "F", "F", "F", "F", "F", "F", "F", "F", "F", "F", "W", "F", "F", "F", "F", "F", "F", "F", "F", "F", "F"],
    ["F", "F", "F", "F", "F", "W", "F", "F", "F", "F", "F", "F", "F", "F", "F", "F", "F", "W", "F", "F", "F", "F", "F", "F", "F", "F", "F", "F"],
    ["F", "F", "F", "F", "F", "W", "F", "F", "F", "F", "F", "F", "F", "F", "F", "F", "F", "W", "F", "F", "F", "F", "F", "F", "F", "F", "F", "F"],
    ["F", "F", "F", "F", "F", "W", "F", "F", "F", "F", "F", "F", "F", "F", "F", "F", "F", "W", "F", "F", "F", "F", "F", "F", "F", "F", "F", "F"]
  ],
  "start_grid": {
    "grid_x": 1,
    "grid_y": 9
  },
  "enemys": [
    {
      "enemy_type": "orange",
      "start_grid": {
        "grid_x": 27,
        "grid_y": 9
      }
    }
  ]
}