{
  "map": [
    ["F", "F", "F", "F", "F", "F", "F", "F", "F", "F", "F", "F", "F", "F", "F", "F", "F", "F", "F", "F", "F", "F", "F", "F"],
    ["F", "F", "F", "F", "F", "F", "F", "F", "F", "F", "F", "F", "F", "F", "F", "F", "F", "F", "F", "F", "F", "F", "F", "F"],
    ["F", "F", "F", "F", "F", "F", "F", "F", "F", "F", "F", "F", "F", "F", "F", "F", "F", "F", "F", "F", "F", "F", "F", "F"],
    ["F", "F", "F", "F", "C", "F", "F", "F", "F", "F", "F", "F", "F", "F", "F", "F", "F", "F", "F", "C", "F", "F", "F", "F"],
    ["F", "F", "F", "F", "C", "F", "F", "F", "F", "C", "F", "F", "F", "F", "C", "F", "F", "F", "F", "C", "F", "F", "F", "F"],
    ["F", "F", "F", "F", "W", "F", "F", "F", "F", "C", "F", "F", "F", "F", "C", "F", "F", "F", "F", "W", "F", "F", "F", "F"],
    ["F", "F", "F", "F", "W", "F", "F", "F", "F", "W", "F", "F", "F", "F", "W", "F", "F", "F", "F", "W", "F", "F", "F", "F"],
    ["F", "F", "F", "F", "W", "F", "F", "F", "F", "W", "F", "F", "F", "F", "W", "F", "F", "F", "F", "W", "F", "F", "F", "F"],
    ["F", "F", "F", "F", "W", "F", "F", "F", "F", "W", "F", "F", "F", "F", "W", "F", "F", "F", "F", "W", "F", "F", "F", "F"],
    ["F", "F", "F", "F", "W", "F", "F", "F", "F", "W", "F", "F", "F", "F", "W", "F", "F", "F", "F", "W", "F", "F", "F", "F"],
    ["F", "F", "F", "F", "W", "F", "F", "F", "F", "C", "F", "F", "F", "F", "C", "F", "F", "F", "F", "W", "F", "F", "F", "F"],
    ["F", "F", "F", "F", "C", "F", "F", "F", "F", "C", "F", "F", "F", "F", "C", "F", "F", "F", "F", "C", "F", "F", "F", "F"],
    ["F", "F", "F", "F", "C", "F", "F", "F", "F", "F", "F", "F", "F", "F", "F", "F", "F", "F", "F", "C", "F", "F", "F", "F"],
    ["F", "F", "F", "F", "F", "F", "F", "F", "F", "F", "F", "F", "F", "F", "F", "F", "F", "F", "F", "F", "F", "F", "F", "F"],
    ["F", "F", "F", "F", "F", "F", "F", "F", "F", "F", "F", "F", "F", "F", "F", "F", "F", "F", "F", "F", "F", "F", "F", "F"],
    ["F", "F", "F", "F", "F", "F", "F", "F", "F", "F", "F", "F", "F", "F", "F", "F", "F", "F", "F", "F", "F", "F", "F", "F"]
  ]
}