{
  "grid_map": [
    ["F", "F", "F", "F", "F", "F", "F", "F", "F", "F", "F", "F", "F", "F", "F", "F", "F", "F", "F", "F", "F", "F", "F", "F"],
    ["F", "F", "F", "F", "F", "F", "F", "F", "F", "F", "F", "F", "F", "F", "F", "F", "F", "F", "F", "F", "F", "F", "F", "F"],
    ["F", "F", "F", "F", "F", "F", "F", "F", "F", "F", "F", "F", "F", "F", "F", "F", "F", "F", "F", "F", "F", "F", "F", "F"],
    ["F", "F", "F", "F", "C", "F", "F", "F", "F", "F", "F", "F", "F", "F", "F", "F", "F", "F", "F", "C", "F", "F", "F", "F"],
    ["F", "F", "F", "F", "C", "F", "F", "F", "F", "C", "F", "F", "F", "F", "C", "F", "F", "F", "F", "C", "F", "F", "F", "F"],
    ["F", "F", "F", "F", "W", "F", "F", "F", "F", "C", "F", "F", "F", "F", "C", "F", "F", "F", "F", "W", "F", "F", "F", "F"],
    ["F", "F", "F", "F", "W", "F", "F", "F", "F", "W", "F", "F", "F", "F", "W", "F", "F", "F", "F", "W", "F", "F", "F", "F"],
    ["F", "F", "F", "F", "W", "F", "F", "F", "F", "W", "F", "F", "F", "F", "W", "F", "F", "F", "F", "W", "F", "F", "F", "F"],
    ["F", "F", "F", "F", "W", "F", "F", "F", "F", "W", "F", "F", "F", "F", "W", "F", "F", "F", "F", "W", "F", "F", "F", "F"],
    ["F", "F", "F", "F", "W", "F", "F", "F", "F", "W", "F", "F", "F", "F", "W", "F", "F", "F", "F", "W", "F", "F", "F", "F"],
    ["F", "F", "F", "F", "W", "F", "F", "F", "F", "C", "F", "F", "F", "F", "C", "F", "F", "F", "F", "W", "F", "F", "F", "F"],
    ["F", "F", "F", "F", "C", "F", "F", "F", "F", "C", "F", "F", "F", "F", "C", "F", "F", "F", "F", "C", "F", "F", "F", "F"],
    ["F", "F", "F", "F", "C", "F", "F", "F", "F", "F", "F", "F", "F", "F", "F", "F", "F", "F", "F", "C", "F", "F", "F", "F"],
    ["F", "F", "F", "F", "F", "F", "F", "F", "F", "F", "F", "F", "F", "F", "F", "F", "F", "F", "F", "F", "F", "F", "F", "F"],
    ["F", "F", "F", "F", "F", "F", "F", "F", "F", "F", "F", "F", "F", "F", "F", "F", "F", "F", "F", "F", "F", "F", "F", "F"],
    ["F", "F", "F", "F", "F", "F", "F", "F", "F", "F", "F", "F", "F", "F", "F", "F", "F", "F", "F", "F", "F", "F", "F", "F"]
  ],
  "start": {
    "grid_x": 1,
    "grid_y": 8.5
  }
}