{
  "stage_id": 2,
  "grid_map": [
    ["F", "F", "F", "F", "F", "F", "F", "F", "F", "F", "W", "F", "F", "F", "F", "F", "F", "F", "F", "W", "F", "F", "F", "F", "F", "F", "F", "F"],
    ["F", "F", "F", "F", "F", "F", "F", "F", "F", "F", "W", "F", "F", "F", "F", "F", "F", "F", "F", "W", "F", "F", "F", "F", "F", "F", "F", "F"],
    ["F", "F", "F", "F", "F", "F", "F", "F", "F", "F", "W", "F", "F", "F", "F", "F", "F", "F", "F", "W", "F", "F", "F", "F", "F", "F", "F", "F"],
    ["F", "F", "F", "F", "F", "F", "F", "F", "F", "F", "W", "F", "F", "F", "F", "F", "F", "F", "F", "W", "F", "F", "F", "F", "F", "F", "F", "F"],
    ["F", "F", "F", "F", "F", "F", "F", "F", "F", "F", "W", "F", "F", "F", "F", "F", "F", "F", "F", "W", "F", "F", "F", "F", "F", "F", "F", "F"],
    ["F", "F", "F", "F", "F", "F", "F", "F", "F", "F", "W", "W", "W", "W", "F", "F", "F", "F", "W", "W", "W", "W", "W", "F", "F", "F", "F", "W"],
    ["F", "F", "F", "F", "F", "F", "F", "F", "F", "F", "F", "F", "F", "F", "F", "F", "F", "F", "F", "F", "F", "F", "F", "F", "F", "F", "F", "F"],
    ["F", "F", "F", "F", "F", "F", "F", "F", "F", "F", "F", "F", "F", "F", "F", "F", "F", "F", "F", "F", "F", "F", "F", "F", "F", "F", "F", "F"],
    ["F", "F", "F", "F", "F", "F", "F", "F", "F", "W", "F", "F", "F", "F", "F", "F", "F", "F", "W", "F", "F", "F", "F", "F", "F", "F", "F", "F"],
    ["F", "F", "F", "F", "F", "F", "F", "F", "F", "W", "F", "F", "F", "F", "F", "F", "F", "F", "W", "F", "F", "F", "F", "F", "F", "F", "F", "F"],
    ["F", "F", "F", "F", "F", "F", "F", "F", "F", "F", "F", "F", "F", "F", "F", "F", "F", "F", "F", "F", "F", "F", "F", "F", "F", "F", "F", "F"],
    ["F", "F", "F", "F", "F", "F", "F", "F", "F", "F", "F", "F", "F", "F", "F", "F", "F", "F", "F", "F", "F", "F", "F", "F", "F", "F", "F", "F"],
    ["F", "F", "F", "F", "F", "F", "F", "F", "F", "F", "W", "W", "W", "W", "F", "F", "F", "F", "W", "W", "W", "W", "W", "F", "F", "F", "F", "W"],
    ["F", "F", "F", "F", "F", "F", "F", "F", "F", "F", "W", "F", "F", "F", "F", "F", "F", "F", "F", "W", "F", "F", "F", "F", "F", "F", "F", "F"],
    ["F", "F", "F", "F", "F", "F", "F", "F", "F", "F", "W", "F", "F", "F", "F", "F", "F", "F", "F", "W", "F", "F", "F", "F", "F", "F", "F", "F"],
    ["F", "F", "F", "F", "F", "F", "F", "F", "F", "F", "W", "F", "F", "F", "F", "F", "F", "F", "F", "W", "F", "F", "F", "F", "F", "F", "F", "F"],
    ["F", "F", "F", "F", "F", "F", "F", "F", "F", "F", "W", "F", "F", "F", "F", "F", "F", "F", "F", "W", "F", "F", "F", "F", "F", "F", "F", "F"],
    ["F", "F", "F", "F", "F", "F", "F", "F", "F", "F", "W", "F", "F", "F", "F", "F", "F", "F", "F", "W", "F", "F", "F", "F", "F", "F", "F", "F"]
  ],
  "start_grid": {
    "grid_x": 3,
    "grid_y": 9
  },
  "enemys": [
    {
      "enemy_type": "orange",
      "start_grid": {
        "grid_x": 15,
        "grid_y": 3
      }
    },
    {
      "enemy_type": "orange",
      "start_grid": {
        "grid_x": 24,
        "grid_y": 15
      }
    }
  ]
}